###################
#......|...|......############
#......#####....R.|..........#
#..@...#   #......##########.#
#......#   ###|####        #.#
########     #.#           #.#
             #.#           #.#
             #.#           #.#
             #.#        ####.####
             #.#        #.......#
##############|##########.......############
#..........................................#
#..............................#############
#...........S..................#
#..............................#
#..............................#
#.......................S......#
#..............................#
#..............................#
#........#################################
#........................................#
#........................................#
#.................R......................#
#...................................R....#
#.............................d..........#
#........................................#
#.........................S..............#
#........................................#
##########################################
   
   