################################
#.............#................#
#.u@..........#....S.....S.....#
#.............#................#
###########|###................#
          #...........S........#
          #....................#
          ######################