###############
#.............#
#.@.......u...#
#.............#
###############