###################
#......|...|......#
#......#####......#
#..P...#   #......#
#......#   ###|####
########     #.#
             #.#
             #.#
             #.#
             #.#
##############|#########################################################
#......................................................................#
#......................................................................#
#......................................................................#
#......................................................................#
#......................................................................#
#......................................................................#
#......................................................................#
#......................................................................#
#......................................................................#
#......................................................................#
#......................................................................#
#......................................................................#
#......................................................................#
#......................................................................#
#......................................................................#
#......................................................................#
#......................................................................#
########################################################################
   
   