###################
#......|...|......############
#......#####......|..........#
#......#   #......##########.#
#......#   ###|####        #.#
########     #.#           #.#
             #.#           #.#
             #.#           #.#
             #.#        ####.####
             #.#        #.......#
##############|##########.......############
#..........................................#
#..............................#############
#..............................#
#..............................#
#..........R..............@....#
#..........S...................#
#..............................#
#..............................#
#........#################################
#........................................#
#........................................#
#........................................#
#........................................#
#........................................#
#........................................#
#........................................#
#........................................#
##########################################
   
   