###################
#......|...|......############
#......#####...R..|..........#
#..@...#   #......##########.#
#......#   ###|####        #.#
########     #.#           #.#
             #.#           #.#
             #.#           #.#
             #.#        ####.####
             #.#        #.......#
##############|##########.......############
#.........................................S#
#..............................#############
#..............................#
#..............................#
#..........R...................#
#..............................#
#..............................#
#..............................#
#........#################################
#........................................#
#........................................#
#........................................#
#........................................#
#........................................#
#....................S...................#
#........................................#
#........................................#
##########################################
   
   